0 13 31
###############################
#p     ** *    *   *  * * *   #
# # # #*# # #*#*# # # #*#*#*# #
#  x*     ***  *      *   * * #
#4# # # # #*# # #*#*# # # # #*#
#f         x **  *  *         #
# # # # # # # # # #*# #*# # # #
#*  *      *  *      *        #
# # # # #*# # # #*#*# # # # # #
#*    **  *       *           #
# #*# # # # # # #*# # # # # # #
#           *   *  *          #
###############################
1 13 31
###############################
#p     ** *  1 * 2 *  * * *   #
# # # #*# # #*#*# # # #*#*#*# #
#  x*     ***  *      *   * * #
# # # # # #*# # #*#*# # # # #*#
#f         x **  *  *   1     #
# # # # # # # # # #*# #*# # # #
#*  *      *  *      *        #
# # # # #*# # # #*#*# # # # # #
#*    **  *       *           #
# #*# # # # # # #*# # # # # # #
#           *   *  *          #
###############################
9 13 22
######################
#p     ** *    *   * #
# # # #*# # #*#*# # ##
#   *     ***  *     #
# # # # # #*# # #*#* #
#f           **  *   #
# # # # # # # # # #* #
#*  *      *  *      #
# # # # #*# # # #*#* #
#*    **  *     b *  #
# #*# # # # # # #*#  #
#           *   * * p#
######################